Input file name,Time Created,Interpolation,DPI,Input file size,Output image size,Bytes lost,Percent loss
.gitignore,2023-11-22 22:11:08.714098,nearest,600,13,12,1,0.07692307692307693
Limewire_5.5.16.exe,2023-11-22 22:11:10.089300,nearest,600,30164216,30146700,17516,0.0005806880576640878
.gitignore,2023-11-22 22:11:14.130336,nearest,600,13,12,1,0.07692307692307693
Limewire_5.5.16.exe,2023-11-22 22:17:12.988205,nearest,600,30164216,30146700,17516,0.0005806880576640878
1.56c_slsk156c.exe,2023-11-22 22:36:05.342746,nearest,600,842672,839523,3149,0.0037369225511230944
5.8.3.0_morpheus_pro_free.exe,2023-11-22 22:36:08.559568,nearest,600,6936296,6931200,5096,0.0007346860629938515
Limewire_5.5.16.exe,2023-11-22 22:36:12.107464,nearest,600,30164216,30146700,17516,0.0005806880576640878
icqpro2003b.exe,2023-11-22 22:36:16.641215,nearest,600,4610480,4605363,5117,0.001109862747479655
klitekpp243e-32-bit.exe,2023-11-22 22:36:19.627553,nearest,600,3366186,3364443,1743,0.0005177966992911265
napster2b103.exe,2023-11-22 22:36:22.179574,nearest,600,1928256,1924803,3453,0.001790737329483222