Input file name,Time Created,Interpolation,DPI,Input file size,Output image size,Bytes lost,Percent loss
.gitignore,2023-11-22 22:11:08.714098,nearest,600,13,12,1,0.07692307692307693
Limewire_5.5.16.exe,2023-11-22 22:11:10.089300,nearest,600,30164216,30146700,17516,0.0005806880576640878
.gitignore,2023-11-22 22:11:14.130336,nearest,600,13,12,1,0.07692307692307693
Limewire_5.5.16.exe,2023-11-22 22:17:12.988205,nearest,600,30164216,30146700,17516,0.0005806880576640878
1.56c_slsk156c.exe,2023-11-22 22:36:05.342746,nearest,600,842672,839523,3149,0.0037369225511230944
5.8.3.0_morpheus_pro_free.exe,2023-11-22 22:36:08.559568,nearest,600,6936296,6931200,5096,0.0007346860629938515
Limewire_5.5.16.exe,2023-11-22 22:36:12.107464,nearest,600,30164216,30146700,17516,0.0005806880576640878
icqpro2003b.exe,2023-11-22 22:36:16.641215,nearest,600,4610480,4605363,5117,0.001109862747479655
klitekpp243e-32-bit.exe,2023-11-22 22:36:19.627553,nearest,600,3366186,3364443,1743,0.0005177966992911265
napster2b103.exe,2023-11-22 22:36:22.179574,nearest,600,1928256,1924803,3453,0.001790737329483222
1.56c_slsk156c.exe,2023-12-30 18:47:24.722550,nearest,600,842672,839523,3149,0.0037369225511230944
.DS_Store,2023-12-30 18:47:26.588044,nearest,600,6148,6075,73,0.011873780091086533
1.56c_slsk156c.exe,2023-12-30 18:47:35.241574,nearest,600,842672,839523,3149,0.0037369225511230944
.DS_Store,2023-12-30 18:47:36.289688,nearest,600,6148,6075,73,0.011873780091086533
1.56c_slsk156c.exe,2023-12-31 01:08:24.188756,nearest,600,842672,839523,3149,0.0037369225511230944
.DS_Store,2023-12-31 01:08:26.282925,nearest,600,6148,6075,73,0.011873780091086533
1.56c_slsk156c.exe,2023-12-31 01:08:40.088537,nearest,600,842672,839523,3149,0.0037369225511230944
.DS_Store,2023-12-31 01:08:42.385092,nearest,600,6148,6075,73,0.011873780091086533
1.56c_slsk156c.exe,2023-12-31 05:44:49.325608,nearest,600,842672,839523,3149,0.0037369225511230944
.DS_Store,2023-12-31 05:44:51.607461,nearest,600,6148,6075,73,0.011873780091086533
1.56c_slsk156c.exe,2023-12-31 05:45:05.753244,nearest,600,842672,839523,3149,0.0037369225511230944
.DS_Store,2023-12-31 05:45:08.890407,nearest,600,6148,6075,73,0.011873780091086533
1.56c_slsk156c.exe,2023-12-31 06:02:20.637759,nearest,600,842672,839523,3149,0.0037369225511230944
.DS_Store,2023-12-31 06:02:27.072326,nearest,600,6148,6075,73,0.011873780091086533
1.56c_slsk156c.exe,2023-12-31 06:02:40.256968,nearest,600,842672,839523,3149,0.0037369225511230944
.DS_Store,2023-12-31 06:02:43.563611,nearest,600,6148,6075,73,0.011873780091086533
.DS_Store,2023-12-31 21:17:09.311421,nearest,600,6148,6075,73,0.011873780091086533
1.56c_slsk156.exe,2023-12-31 21:17:09.969999,nearest,600,842672,839523,3149,0.0037369225511230944
1.56c_slsk156.exe,2024-01-07 17:17:08.309765,nearest,600,842672,839523,3149,0.0037369225511230944
1.56c_slsk156.exe,2024-01-07 17:32:49.486588,nearest,600,842672,839523,3149,0.0037369225511230944
1.56c_slsk156.exe,2024-01-07 17:42:52.507927,nearest,600,842672,839523,3149,0.0037369225511230944
1.56c_slsk156.exe,2024-01-07 17:49:19.822662,nearest,600,842672,839523,3149,0.0037369225511230944
1.56c_slsk156.exe,2024-01-07 17:59:10.449530,nearest,600,842672,839523,3149,0.0037369225511230944
1.56c_slsk156.exe,2024-01-07 18:35:36.094236,nearest,600,842672,839523,3149,0.0037369225511230944
1.56c_slsk156.exe,2024-01-07 18:36:36.063959,nearest,600,842672,839523,3149,0.0037369225511230944
1.56c_slsk156.exe,2024-01-07 18:40:32.214200,nearest,600,842672,839523,3149,0.0037369225511230944
1.56c_slsk156.exe,2024-01-07 18:40:37.540103,nearest,600,842672,839523,3149,0.0037369225511230944
1.56c_slsk156.exe,2024-01-07 19:24:44.096180,nearest,600,842672,839523,3149,0.0037369225511230944
1.56c_slsk156.exe,2024-01-07 21:59:51.238754,nearest,600,842672,839523,3149,0.0037369225511230944
1.56c_slsk156.exe,2024-01-07 22:05:52.292007,nearest,600,842672,839523,3149,0.0037369225511230944
1.56c_slsk156.exe,2024-01-07 22:14:26.176467,nearest,600,842672,839523,3149,0.0037369225511230944
1.56c_slsk156.exe,2024-01-07 22:19:32.749807,nearest,600,842672,839523,3149,0.0037369225511230944
1.56c_slsk156.exe,2024-01-07 22:27:41.922417,nearest,600,842672,839523,3149,0.0037369225511230944
1.56c_slsk156.exe,2024-01-07 22:34:30.874733,nearest,600,842672,839523,3149,0.0037369225511230944
1.56c_slsk156.exe,2024-01-07 22:39:02.189737,nearest,600,842672,839523,3149,0.0037369225511230944
1.56c_slsk156.exe,2024-01-07 22:39:46.250955,nearest,600,842672,839523,3149,0.0037369225511230944
1.56c_slsk156.exe,2024-01-07 22:43:44.742449,nearest,600,842672,839523,3149,0.0037369225511230944
1.56c_slsk156.exe,2024-01-07 22:48:03.692401,nearest,600,842672,839523,3149,0.0037369225511230944
1.56c_slsk156.exe,2024-01-07 22:51:23.481705,nearest,600,842672,839523,3149,0.0037369225511230944
1.56c_slsk156.exe,2024-01-08 01:16:29.468017,nearest,600,842672,839523,3149,0.0037369225511230944
1.56c_slsk156.exe,2024-01-08 01:21:31.351011,nearest,600,842672,839523,3149,0.0037369225511230944
1.56c_slsk156.exe,2024-01-08 01:24:31.035914,nearest,600,842672,839523,3149,0.0037369225511230944
1.56c_slsk156.exe,2024-01-08 01:34:56.496202,nearest,600,842672,839523,3149,0.0037369225511230944
1.56c_slsk156.exe,2024-01-08 01:35:55.816936,nearest,600,842672,839523,3149,0.0037369225511230944
1.56c_slsk156.exe,2024-01-08 01:53:51.819951,nearest,600,842672,839523,3149,0.0037369225511230944
1.56c_slsk156.exe,2024-01-08 02:10:59.321818,nearest,600,842672,839523,3149,0.0037369225511230944
1.56c_slsk156.exe,2024-01-08 02:25:44.892966,nearest,600,842672,839523,3149,0.0037369225511230944
1.56c_slsk156.exe,2024-01-08 02:26:09.184800,nearest,600,842672,839523,3149,0.0037369225511230944
1.56c_slsk156.exe,2024-01-08 02:29:07.594196,nearest,600,842672,839523,3149,0.0037369225511230944
1.56c_slsk156.exe,2024-01-08 03:22:19.630017,nearest,600,842672,839523,3149,0.0037369225511230944
1.56c_slsk156.exe,2024-01-07 22:23:32.426255,nearest,600,842672,839523,3149,0.0037369225511230944
1.56c_slsk156.exe,2024-01-08 03:34:20.022039,nearest,600,842672,839523,3149,0.0037369225511230944
1.56c_slsk156.exe,2024-01-08 03:34:41.367103,nearest,600,842672,839523,3149,0.0037369225511230944
cli-64.exe,2024-01-08 03:36:10.481684,nearest,600,41984,41772,212,0.005049542682926829
Limewire_5.5.16.exe,2024-01-08 03:38:56.131246,nearest,600,30164216,30146700,17516,0.0005806880576640878
cli-64.exe,2024-01-10 17:48:52.992910,nearest,600,41984,41772,212,0.005049542682926829
cli-64.exe,2024-01-10 18:13:34.054214,nearest,600,41984,41772,212,0.005049542682926829
cli-64.exe,2024-01-10 18:15:22.199099,nearest,600,41984,41772,212,0.005049542682926829
cli-64.exe,2024-01-10 18:17:17.541150,nearest,600,41984,41772,212,0.005049542682926829
1.56c_slsk156.exe,2024-01-10 18:18:02.695382,nearest,600,842672,839523,3149,0.0037369225511230944
1.56c_slsk156.exe,2024-01-10 18:23:27.994761,nearest,600,842672,839523,3149,0.0037369225511230944
cli-64.exe,2024-01-10 18:24:13.851852,nearest,600,41984,41772,212,0.005049542682926829
1.56c_slsk156.exe,2024-01-10 18:24:22.951511,nearest,600,842672,839523,3149,0.0037369225511230944
1.56c_slsk156.exe,2024-01-10 18:25:14.879522,nearest,600,842672,839523,3149,0.0037369225511230944
1.56c_slsk156.exe,2024-01-10 18:25:50.875764,nearest,600,842672,839523,3149,0.0037369225511230944
Limewire_5.5.16.exe,2024-01-10 18:26:56.764052,nearest,600,30164216,30146700,17516,0.0005806880576640878
1.56c_slsk156.exe,2024-01-10 18:29:18.565078,nearest,600,842672,839523,3149,0.0037369225511230944